*********
+..*.....
**..*.**.
*.*...*..
*.******.
*....*...
**.*.*.**
*..*....*
*******o*